R    840    360

SO    ./Textures/beth.xpm
WE ./Textures/bleu.xpm
NO    ./Textures/plat.xpm
EA ./Textures/panth.xpm

C 220, 150  , 200   
F 120, 10 ,80

        1111111111111111111111111
        1000000000110000000000001
        1100000001110000000000001
        1001000000000000000001111
111111111011000001110000000001
1000000000011000001110111111111111
11110111111111011100000010001
11110111111111011101010010001111
  110000001101010111000000100000111
11000000000000000110000000101111
1000000000000011001010010001
110000011101010111110110100111
11110111 1110101 101111010N1
11111111 1111111 11111111111
1111111111111
1000000000001
1111111111111
